#  ##
#   #
#  ##
#   #
##  #
