#  #########
#    #   # #
## #   #  ##
# # # #  # #
# # #   #  #
#    # # # #
## #       #
#     #  # #
## # #  #  #
#  #  #    #
##  #   #  #
#########  #
