#  ###########################################################
#  #    #  #  # # #     #   #       # # # #    #  # # #  #  ##
#    #    #        # # # #  # # #  #     # #  #       # #  # #
## # #  #  # # # # #   #  #    # #   #  #       #  # #       #
#  #   # #  # #   # # #  #  # #  # #  #   # # # # # #  # # # #
##   # #   #     #      # #  #    # #  # # #  #    #  #     ##
# #  #  # # #  #   #  # #  #   # #    #    # #  # #  # # # # #
#     #   #    #  #       #  # # #  #  # #   #  #  # #    #  #
# # # # #  # #  #  #  # #   # #    #  # #  #   #  # #  # #   #
# #     # #   #  #  #  #  #  #   # # #  # #  #  #     #   # ##
##   # #    #  #   #  # #   # # #   #  #    #  #  #  # #   # #
#  #    # #  #  # # #    # #  #   #  #   # #  # #  # #   #   #
## # # #  #    # #  # #   #     #   # #   # #     # #  #   # #
#  # #  #  # #     #    #  # # # #  #    #  # # #    #  # #  #
##  #  #  #    # #    #   #          # #     # # # # # # # # #
#  #  # #   # #    # #   # # # # # #  # # #   #       #  # # #
## #    #  #  # #     # #   #   #  #     # # # #  # #  #     #
#    # #  #     #  # #  # # # # # # # #        #   # #  # #  #
## #  #    # # #  # #    #    #   # #   # #  #  # #  #      ##
# #  #  # # # # #   #  #   #   #   # # # #  # #    #  # # #  #
#  #   #    # # # #   #  #    #   #      #      # #  #  #  # #
##   #  #  # #  # #  #  #  # #  # # #  #   # # # #  # # # # ##
#  #   #      #   # #  #  #  #        # #   # #  #    #   #  #
# #   # # #  # #         #  #  # # #      #  # #   # # #   # #
#  #     #    #  #  # # #  #  #   #   # #   #  # #   # # #   #
##  # # # #  #  # # #    # # # # # # # # #  #  #  # #  #  #  #
# #  #      #  # # # # #   #    # #  #  #  # #   #    #  # # #
## # # # # #  #     #  # #   #     #  #  #     #  # #  #     #
#         # #  # # #  # # #   #  #   #  #  # # # # # #  #  # #
# #  # # # #  #  #    #  # #        #     #   #   #  #     # #
##  #   #   #  #  # #  #     # # #  # #  #  #  #    #  # #   #
#  #  #    # # #  #    # #  # #   #  #  #  #    # #  #  #   ##
##      # #       # # # #     # #  #       #  # #  #   # # # #
# # # #  #   #  #         # #    #  #  # #   #  # #  # #    ##
#   #  #    # # # # # # #   # # # #  # #  # #  #   #  # # #  #
# #   # # #    # #  # #   #       # # #  #   #  # #  #       #
#  # #  #  #  #  # #  # #  # # # # # # #  #  # #   #  # # # ##
##  #  # #   #  #  #    # #   #  #  #  # #   #  #   # #  #   #
#  # # #  # #  #  #  #  #   #  # # #  #   # #  #  #  # #   # #
##   #  # # #       #  # #  # #      #  # #  # #          #  #
# # #  #  #  # #  #  # #  #  #   # # # #   # #   # # # #  # ##
#     # #   #  #  #  # #      # #  #  # #   #  #    # #   #  #
# # # #  #   #  #   #     # #     #  # #   # # #  #     #    #
##  # # #  #     #   # # # #  #  # #    # #  #   #  # #  # # #
#  #     # # # # #  # #     #  # #  # #     #  #  #   #   #  #
# # # # #     # #  #    # #   # #  #  #  #   # #  # # # # # ##
#    #  # # #    #  # #  # # #   # # # #   #  # #           ##
# # #  #   #   #   # #  #     #  # #    # # #   # # # #  #   #
# #     #    # #  #  # # # # # #    # #  #    #    # # # # # #
## # #    #  #  #  #      # #    #  #   # #  #   #    #     ##
#   #  # #  #  # #   # # #  # # #     # # # #  #    #  # # # #
## #  #  #        # #   #  # # # # # # #      #  #  #  #  # ##
# #  #  #  #  # # #   # #    # # # #      # #  # # #  # #    #
##  #  #  #    #    # #   # #  #    # # #   #        #  # # ##
# #  #  # #  #   # #   #  #  #  # #   #  # #  #  # #  #      #
#   #       # # #   # #    #  #    # #  # #  #  # #   # # # ##
## #  # #  #   #  # #  # #   # # #     # #  # #      # #  #  #
##   #    #   #  # # # # # # #   # # #     #   # #  #  #   # #
# # # # # # #  # # #  #   # # #   #    # #  # #   #  #    #  #
# # #    # #  #  # # #  #   # #  # #  #   #     #      # #  ##
#    # #       #      #  # #        #   #    #    #  #    #  #
###########################################################  #
