#  #############################
#    #   #   # #  #  #      #  #
# #    #  # #    #     #  #    #
#  # #        # # # # #  #  #  #
##     # # # #      # # #  # # #
## #  # #  # # # #   #  # #    #
# #  #   #    #    #   # #   # #
# # #  #    #  # #  #     # # ##
#   #    # #  # # #  #  #      #
# # # # # #    #  # # #   # #  #
# #   # #   # #  # #    # # #  #
#  # # # # #   # #  # # #    # #
# #         #      #  #  #  #  #
##   # #  # # # #    #  #  #   #
#  #         #  # # #  #     # #
# #  # #  # # # #   #  # #  #  #
#  #  #  # # #   #    #    #  ##
# # # # #     # #  #    # #  # #
## # #    # #  # #   #  #   #  #
#     # #  #     # #     # # # #
## #    # #  # #      #   #    #
#    #  #      # # # # # # # # #
## #  #    # # #  #     # #  # #
#   #  # #  # # #  #  # # #    #
## # #    #         #  #   # # #
#  #   # # #  # # # # #  #   # #
# #  #   #  #    # #  # #  #  ##
#   # # #  #  #      #   # #   #
## #   #  # #  #  #  # # #   # #
##    # #     # #  #  #   # # ##
#  # #     #    # # #   #      #
#############################  #
