#  ###################################################################################################
#   #  # # #  #  #    # #  #  #     #   #   #  #   #      #  # # #     # #  #     # #  #  # # #  #   #
# #  #  #    #  # #  #    # #  #  #  # #  #  #   #  #  #    #   # # #  #  #  # # #   #   #  #  #    ##
## #   #  #   #      # # #  # #   #     # #     #  #    # #   #     # #  #  #      #   # #   #  # #  #
## #  # # # #  # # #  #  #     # #  # #    #  #  # # # # # # # # # #    #     #  #   #  # # #  #   # #
#      #     #  #      #   # # #  #     #  #  # #    #  #  #    # # # #   # #  # # #   #      #  #   #
## # #  # # # # # # # # # #  #  #    # #     # # # #  #   #   #   #   # # #   #   #  #   # # # #  # ##
#         # # #   #     #  #  #  # #  # # # # #  #  # #  #  #   #   #       #   #  #   #  # #   # #  #
## #  # #  #    #  # # # #  #  # # #       #   #   # # #   # # #  #  # # #  #  # #  #  # #  # #   #  #
#   #  # #    #   #     #  #  #   # # #  # # #  #     #  #  #       #   #    #     #      # #    # # #
# #  #   #  #   #  # # # #  #   # #   # # #       # #   # #  #  #  #  # #  #  # # # # # #     # #  # #
#  #  # # #  # # # #    #  #  #  # # #   #  # #  #  # #  #     #  # #    #   #       # #  # # # # #  #
# # #  #   #         # #  #  # #    # # #  # #  #  #       # #  #     # # # #  # # # #  # # #  #    ##
##   #   #  # # # # #       # # # #  # # #      # #  #  # # # #  #  #      #  #  #  # # #    #    #  #
#  #   #  #  # # #   #  # #              #  # #  #   # #        # #   # # # #  #    #    # #    #  # #
# #  #  #         #   # # # # #  #  #  #  #  #  #   #   # # # # #    #  #     # #  # #  #   # #  # # #
#  #  #   #  # # # # # #   #    #   #  # # #   #  #   # # # # #  # #   #  # #     #        #  #   #  #
## # #  #  #  #   #     # # # #   #  #  #  #  #  # # #       # #  #  #   #    #  # # # # #  #  # #   #
#  #  # # #   # #  #  #    # #  #  #  #  #  #    #   # #  #   # #  #   #  # #   #   # #   #   # # #  #
# # #   #  # # #  #  #  #      #    #  #  # # #    # # # #   #   # # #  #   #  # # #     # # #   #   #
#  #  #  #     #   # #   # # #  #  #  #  #   #  # # # #    #  #   #    #  #  # # #  # # #   #  #  #  #
# # #  #   #  #   #     #   #  # # #   #   #   # # #   #  #  # # #  # #      # #      #  # #  # #    #
#  #  #  #   #  #   # #   #  #  #   # #  # # #  #   # #    #      # #  # # #     #  #  #      #  #  ##
## # #  # # # # # #  # #   #     # # #   #  #     #   #  #  # # # # #    #    #  #  # # # # #  # # # #
#       #    # #       # #  #  #      # #  #  # #   #   #    #  #  #   #   # #    #      #  #  #    ##
# # # #  #  #  #  # # #    #      # # # # # # #   #  # # # #   # #   #   #  # # #  # # #  #  #   # # #
##  #  #  # #   #  #   # # #  # # # # #  #  #   #   #  #    # #  # #   #  #   #  #  #   # #   #  #   #
#  #  # #  # # # # #  #   #    #  #    #      #   #      #     #      #   # #   # #  # # #   #  #  # #
## #     #   #     # # #  # # # #   #   # # # # # #  #  #   # # # # #   #  # #  #  #       #  #   #  #
#    # # #  #  #  # #      #      #   #  # #    #  #   #  # #    # #  #  #    #  # # # # #   #  # #  #
# # # #    #  #        # #  # # #  # # #  # # # #  #  # #   # # #    #  # # #  # #  # #    #   # #  ##
# # #  #  #  # # # #  # # #  #  #  #    #     #   #    # #  # #    #   #  #   #  # #   # #  # #    # #
##    # # # #   #   #  #   # #    #  # #  # #  # # # #    # # # # #  # # #  #  # # # #   # #   # #   #
# # # #    #  #   # # # #  #    #    # # #      # # # # #     # # #        #  #  #   #  # #   #  #  ##
#   # # # #  # #  #     #   # # # # #   # # #  #    # #    # # #     # # #  #  #   # # # #   #  # #  #
# # #  #    #    #   # #  #    #   # # #   # # #  # #  # #      #  #  #  # #   # #         #   #    ##
#  # #    # # # #  #  #  #  # #  # #  # #  #  # # #  # #  #  # # #     #  # #   #   # # # # #  # #   #
# #   # # #    # #   #  #  #    # #  #           #  #    #  # #    #  #  #     #   #  # # #   #     ##
#   #   #   # # #  #  # # #  # #    #  # # # # # #   #  #  #   # #   # # # # #  # #  #    # #   #  # #
# #    # # #       #    #     #  # #  #  #  #  #    # #    # #    # #   #   #  # # #  # #      #   # #
#  # #      #  # #   #   #  #  #  #  #  #    #  # #      #    # # #  # #  #  # #      #  # #  #   #  #
# #    # # #   #   # #  #  # #  #   # #   #   #  #  # # # # #  #    #   #   #    #  #  # # #   # # # #
# # #  # #  #    #  #  #  #   #   #     # # #   #  # #       #    #    #  #  # # #   #    #  #    #  #
# # #   #  # # #  #     #   #   #  #  #  #     # # #  # #  #    #  # # # #  # #   # #  #  # # # #  # #
## #  #  # #   # # # # #  #    # #   # #  # #   #   #  #    # #  #  #     #    # #   #   #    #  #   #
#  #   # #  # #  # #  #  # # #  #  # #  #  # # # # #     # #  #  #    # #  #  # # # #  #   # # #  # ##
# # #  #  #   # #       #   #  #  #  #  # #  #   #  # # #   #  #   #     #   #   #  # #   #    # #   #
# #     #   #  #  # # #   # # # # #        #   #     # # # #  #  #    # #  #  # #  #    #  # #  # #  #
#  #  #  #    # #   # # #  #      # # # # #  #  # # #       #  #  # #    #  # #   # # # # #     # #  #
##   # #   #     # # # #  #  # # # #   #    #  #   # # # #   # # # #  #   #     #  # # # #  # # #   ##
#  # #  # #   #         #   # # #    # #  # # #  #  #    #  #   #   # #  #  # #  # #   #   # #    #  #
## #   #  # #    # #  # #  # #   # #  # #      #  #   #   # # #   #     # #   # # #  #  # #    # # # #
#  # #   #  # # #   #  # #     #    #      #  # #    #  #   # # #  # # #   #    # # #  # # # #   # # #
##   # #   #     #   #     # #   # # # # # # #   # # #    #    # # #  # #    #      # #      # #   # #
## #   # #  # #    #   # #  #  #      # # # #  # # #   # # # #    # # # # # # # # #    # # #  #  #   #
# #   #         # #  # #     #  # # # #      #       #  #   # # #       #        # #  #  # #    #  # #
# # #  # # # # #  # #    # #  #    # # # # #    # #  #   #   # # # # # # # # #  #   # #  #  # #  #   #
#   #  # #       # # # #  # #    #         # # #   #  #  #  #     #  # #  #   #   #    # # #   # #  ##
## # #  # # # # #  #   # # # # #   # #  # #   #   # #      # # # # # #   #  #   # # # #  #   #  #  # #
#     #      #    #  # # #   #  # # #  #   #  #  # # # # #  #      #   #   #  #  #        # #  # #   #
# # #  # # #  # # # #      #   # #  # #  #   #      # #   # # # # #   # # #  #  #  # # #  #  #    # ##
##   #  #   #    # # # # #  # #   # #   #   #  # # #   #  #     #  # #      # #   #  #   # #  # #    #
# # #  #   # #  #       # #   # # #  #  # # # # #  # #   #  # #  #   # # # #  # #  #   # # # # #  #  #
#  #  #  # #    # #  #      #  # #  #    #    #  #  #  #  # #      #     # # #   #  #  # # # #   #   #
##  #   # #  #  #     #  # #  # # #  # #  # #     #  # #  #    # # #  # #  # # #     #  #   #  #   # #
# #  # #    #  # # # # #  # # #     # # #    #  #  #        # #   # # # # #  # # # #  #   #  #   # # #
##  #  # # # #     #     #   #  # #  #   # #   #  # # # #  # #  #    #   #  # # #  #    #  # #  #  # #
#  # #     #  # # #   # # # #  # # #  #  #   # # # #   #  #   #   #     #  #   #  # #  #        # #  #
# # #  # #   #  # # # # # #      # #      # #    #  # #  # # #  # # #  #  # #   # #  #  # #  #   # # #
#  # #    # #     # # # #   # # #   # # #   # # # # #  #  #   # #  # #  #      #    #  #   # #  # #  #
##      #  # # # #  #  # # # #  # # #  #  #       #  # #   # #  # #    #  #  #   #      # # #  # # # #
# # # #           #  #   #   # # #   # # # # # #   #     #     # # # #  #   # #     # #  # #  #      #
#  #   # # # # #    #  #   #        #  #  # #  # # #  # #  # #   #    #   #    # #   # # #   #  #  # #
##   #  #    #   # # # # # # #  #  #  # #   # #      # # # #  # #  # #  # #  # #  # #     # #  #  #  #
#  #  # #  #   # #  #    #  # # #  # #   # #  #  #  #  # #  #  #  # # #     # #  #  # # #    #  #  # #
##  #  #  #  #  # #  # #  # #     #  # #  #  #  # #  #      # #  #     # # #    #  #  # # #  # #  # ##
# # #    #  #  #  # # # #    # # #       #  #  #  # #  #  #    #    # #  #  # # #   # # #   #    #   #
# #   #   #  #  #   #  # # #    #   # #  #  # # # #  #   # #  #  # #   #  #  #   # # #   # #  #    # #
#    #  #  # # #  #   #   #  #    # #  #    #   #     # #   #    #   #   #  # # #  #  #      # # #   #
# # # # # #     # # #   #  # # # #  # # # #   #   # #     #    #  # #  # #     # #  #    # #  #     ##
##  # # #  #  #    #  # #  #    # #  #   #  # # #    #  #  # #     #  # # #  #     #  #  #     # #   #
#  #      #  # #  #  # #   # #     #   #  # #  # #  #  # # # # # # #        # # # # #  #   # # #   # #
# # #  #    #      #   # #   # #  # # #   #  # #     #    #   # # #  # #  #    #  # #   #     #  # # #
#     #  # #  #  #   #  #  #  #    #    # # #     #   # #  #   #    # #  # #  #  #   # #   #   #  #  #
# # #   #    # # # #  #  #  # # # # # #  # # # #  # # #  #   #  # # # #      # #  #  #   #   #  #  # #
## # # #  #  # #    #  #  #    # #  # #     # #      #    # #  #   #   # #  #   #       #  #   # #   #
#       # #     #  #    #  #  #    # #  #  #    #  #   # #    #   # # #   # # #    # # #  #   #   # ##
# #  # # # # # #    #  #  #    # #   # #   # #  # #  #  #  #   # #  #   # # #  #  #   #  #  # #  # # #
## # #   #   #   # #      # # #  # #    # # #          #  #   # # #   # #  # # # #   #  #   #   #    #
#  #  #  # #    #  #  # #      #    # #   #   # #  # #      #   #   #  # # #  #   # # # # # # #  # # #
##   # #   # # # # #  # # # #   #  #     #  #  #  # #  #  #  #   #   # #     #  # #   #   #  # #  #  #
#  # #  # # #    #     #   # #    # # # #         #     #  # # #  #  #   # #    #  # #   #  #     #  #
##     #   # # #   # #  # #    # #     #  # # # #  # #   #     #       #  # # #      # #  #    # #   #
# # # # # #  #   #  # # #   # #  # # #  #  # # #  #  #  # # # #  # # #       #  #  #  # #  # #    # ##
##  # #   # # # # #       # #  # #  #  #             #    #    #  #  # # # # # # #  #  # #    # #    #
#  #    # # #      # # # #  #    # #  # # # #  # # #    #   # # # # # # #   # # #  #  # #  # # #  # ##
##  #  #    # # # #  #  #     #    # #   #  #   #    # #  # #     # # #  # #  #   # # #  # #     #   #
#   #  # # #  # #  #    #  #   #  #  # #   # # #  # #  #  #  #  #         # #   #    # # #  #  #    ##
# #       # #  #  #  # #     #   # #    #     # # #   #  #  #     # # # #     #  # #     # #  # # #  #
#  # # # #    # #  # #   # #  # #     #  # # #   #   # # # # #  #      #  #  # # #    # # # #    # # #
##  # #   # #  #        #         # #  #  #   # #  #    # #      # # #  # #    #  # #  #      # #    #
###################################################################################################  #
