#  ###################
#   #   #  #  # #    #
# #  # #  #  #     # #
## #    #    # # # # #
#  #  #  # #     #   #
##   # #   #  # #  # #
#  #    # #  #    #  #
#   # #    # # # #  ##
##   # # #   #     # #
#  #   #  # # # # #  #
# # #    #  # #   # ##
#   #  #    #    #   #
## # # # # #  #     ##
#    # # #   # # # # #
## #    # # #  #  #  #
#  # # #     #   # # #
## #    #  # # # #  ##
# #  #     #  # #    #
#  # #  #   #    #  ##
## #   #  # #  #  # ##
#    #   # #    #    #
###################  #
