path of length 126 found
#01###########################################################
#12#6789#34#87#5#5#32323#765#7890123#9#1# #1012#45#7#9#56#67##
#2345#9012#87654345#1#1#3#54#6#0#23#78901#7#90#2345678#4#45#7#
##4#6#01#34#8#6#2#6#090#23#3456#6#456#01#5678901#56#8#4323456#
#65#789#9#56#8#012#6#8#01#32#6#45#5#76#234#8#0#2#6# #65#1#3#7#
##678#0#876#87890#456789#5#10#2345#3#56#4#8#21#3456#87#10123##
#2#89#12#6#6#67#123#78#0#45#901#5#1234#6567#1#54#6#09#7#9#3# #
#10901#345#5456#23#9890123#78#2#6#01#56#6#890#45#78#0#6789#  #
#2#0#2#4#67#3#78#45#90#2#456# #8789#76#8#09#123#98#2#45#9#   #
#3#12345#7#123#90#45#90#65#78#098#0#8#67#1#32#45#90123#101# ##
##323#5#9890#45#123#98#0#678#0#0#212#65#3234#65#10#23#5#123#5#
#54#4567#9#12#67#3#3#7890#8#09#901#34#432#4#87#1#90#4#432#454#
##5#5#7#10#2345#9#12#6#890#09878#212#4#212#8#89098#8#65#345#3#
#76#6#89#12#4#67890#4567#12#8#6#8#01#3210#87#9#1#7678#67#5#32#
##78#09#32#6567#9#1234#890#8765678901#3#98765# #5#5#7#7#9#9#1#
#98#21#5#345#7#1012#4#090#2#8#4#8#0#23#7#9#545#5434567#98#8#0#
##9#3234#45#98#2#23456#0#210#234#01#34567#1#3#5#32#6#89#76789#
#1012#4#65#10901#34#6#21#3#9#1#5#9# #5#78901234#212#6#01#5#78#
##1#34#8767#1#1#54#8#2323#7890#678# #678#0#23#56#0#65#123456##
#1#54#89#7#1# #3#567#12#456#012#890#8#8#2#43#7#7890#45#3#5#78#
#09#567#9890# #2#6#890#65#7890#090#678901#545678#0#23#54#67#9#
##876#89#90#4#21#7#90#67#98#0#21#1#5#78#234#6#8#8#01#3#5#7#7##
#09#789#101234#098#0#45#78#21#12323456#0#234# #87#9012#678#65#
#1#989#3#1#34# #090123456#43#90#4#4#678901#56#4#678#2#8#890#4#
#23#90123#5456#21#12#4#6#43#78#656#878#0#234#43#5#901#7#9#123#
##45#1#3#7#56#43# #3#5678#2#6#8#6# #8#8# #45#32#45#1#56#01#34#
# #67#545676#65#9#7# #7#901#5678#2#87#76#65#9#123#3234#21#5#5#
##2#8#6#6#8#87#98767#98#0#234#89012#67#56#67890#45#3#56#23456#
#210987878# #89#9#5#10#4# #456#01#345#54#67#9#1#5# #3#78#23#7#
#3#10#8#8#6#09#98#4321#32#0#67890123#54345#789#767#12#89012#6#
##32#090#456#01#78#4#23#10987#9#1#34#6#23#56#01#7890#87#1#345#
#54#21#1234#2#2#67#5434#2#09#3#323#56#01#34#8901#9#12#67#545##
##543232#4#0123456#6#4#8#01012#4#45#7890123#78#2#01#345#9#5# #
#9#5#3#34#890#45#787656789#1#3456#67#90#2#456#43#1#54#6#8767##
#876#45#5678#2#6#8#8#6#8#012#4#6#0#89#1#34#6#65#323#56#8#8#89#
#9#765#7#7#9012#0#09#7#901#3456789#9# #54#878#67#3#76#8789090#
#01#7#56#89#12#89#1#98#0#23#5#7#9#7# #1#56#89#7#545#78#6#0#8##
##23#54#2#012#67#32#0901#3#767#10#67#90#6#090#89#567#9#54#678#
#43#7#3#10#2#65#54#21#12#456#89#1#5#78#878#0#09#56#89#1#345#9#
##456#23#9#3#5456543#32#0#67#9#323456#09#9#12#0#4567890123#10#
#0#6#01#98#45#3#76#45#3#90#89#543#5#7#1#101#3#123#7#9#1#34#0##
#98789#7#765#32#87#56#4#890901#5#76#89# #123#32#4567#1#345#90#
#0#8#0#67#767#12#876#65678#0#23456#09#3#323#9#3#56#89012#6789#
##09#1#5#98#89012#878#6#8#2#43#56#0#0123#3#78#456#09#1#34#8#0#
#21#32345#9#9#1#3#98#4#09012#45#7#90#2#45456#65#78#012#456#01#
#3#7#3#5#10101#5#10#4321#1#345#1#98#43#56#678#6#89#1#3#5#7#9##
#4567#76#2#2#2345#90#4#23#9#5#109#7#5#9#787#90#4#89012345678##
#5#7#98#434#434#678#6#43#98767#98#6#6789#9#5#123#7#1#3#56#890#
#6#89098#4565#5#78#65#5#9#9#7#1#7654#8#01#5432#4567#1# #7#9#1#
## #0#8765#76#67#90#456789#9#1098#43#901#1#54#656#8901#98901##
#   #09#7#98#87#1#123#7#9#78#2#0#43210#2#0#6#87#7890#23#9#1# #
## #21#98#09098901#3#789#56#8#6#0#4#2#6#898789#98#01#34#01#5##
# #43#10#21#10#0#2#456#0#4567#5#9#5#345678#8#01#9#1#54#8#2345#
##65#32#43#3212#4345#7#123#7#54#8767#5#7#909#12101234#87#3#5##
#0#67#34#4#43#345#5#989#34#89#32#8#876#89#1#32#21#3#56#654567#
#987#5456565#1#5#767#9#5456#01#1090#8#09# #54#43#7#767#7#5#7##
##9#76#6#67#101#98#8#01#5#789#5#1#10901#5#76#4#456787#7#76#89#
##098#8787#109#10#8#0#2#6#8#0#432#2#0#23456#434#6#89#76#878#0#
#6#0#2#8#8#2#89#1#7#90#878#2#0#434#2123#5#78#2#878#01#5678#21#
#5#1#1090#4#67#32#6#8#09#901#9#54#8#23#767#90109#901234#8#43##
#4323#1#1234567#345678#01#1#98765678#456#8901#1010#23#5678#45#
###########################################################56#
