path of length 64 found
#01#############################
#1234#890#656#8#01#78#012345#90#
#2#4567#12#4#6789#76789#34#6789#
#34#6#89012345#9#3#5#9#34#87#90#
##56789#1#3#5#101234#0#2#09#1#1#
##6#89#1#54#6#2#2#456#01#1#9012#
#6#09#109#5678#4345#789#3#989#3#
#5#1#90#8767#90#4#67#90123#7#9##
#432#8909#7#10# #2#89#12#456789#
#5#3#7#1#7#3212#01#9#7#345#7#90#
#6#456#2#654#2#09#1#7654#6#8#01#
#78#6#0#2#4#434#8#01#5#5#7890#2#
#8#878901234#456789#34#67#90#43#
##098#0#23#5#5#7#9012#87#10#454#
#21#901234567#98#0#2#89#32123#5#
#3#10#2#45#7# #9#123#78#2#23#76#
#45#12#65#3#5#101#3456#0123#98##
#5# #3#7#12345#1#54#6789#3#78#6#
##7#5#9890#4#67#1#567#90#456#65#
#76543#9#12#87890#6#89012#6#2#4#
##7#3210#2#67#9#987890#234#2123#
#7654#21#345678#0#8#0#4#4# #0#2#
##7#56#2345#7#9#12#21234#6#09#1#
#989#78#4#67#1#3#34#23#5#5#9890#
##9#1#7656#890123456#45#345#7#1#
#10#098#6#4#01#3#5#7#5#12#676#2#
#2#21#987#34#2345#9#76#0#65#56##
#343#1#9#12#43#567898#098#4#456#
##5#901#10#8#45#78#09#1#7#323#7#
##6789#3#98765#9#90#01#567#1#3##
#87#9#32109#7678#0# #234#890123#
#############################34#
