path of length 20 found
#01#########
#1234#890# #
##3#567#12##
#9#7#7#12#8#
#8#6#890#87#
#7654#0#4#6#
##7#3212345#
#76543#34#6#
##7#5#54#87#
#98#67#5678#
##90#876#89#
#########90#
