path of length 206 found
#01###################################################################################################
#123#10# #2#45#78#6567#5#56#87#76543#101#109#54#098#212345#56#6# #43434#6#21#54567#9#54#67#3#7#10#012#
#2#45#90#0123#76#4#45#5434#4#67#76#21#9#32#87#321#78#01#5654#456#0#2#23#56#01#3#5#789#345#32#65#9890##
##2#678#09#123#543234#6#2#23#5#987#10987#3#76543#76#8901#7#323#78901#1#34#89#123456#012#6#212#45#7#12#
##1#78# #8#0#45#5#1#34#21#12345#7#32#0#6543#76#45#5#7#9# #9#1#3#9#1#1012#67890#45#789#34#8#0#23#567#1#
#109890#87890#67#901234#090#2#6#65#10987#32#87#5#5456#87#78#0123#5#7#9#345#7#90#4#8#012#678901#54#890#
##1#9#12#6#0#4#6#8#2#4#8#8#21#54#4321#9#32109# #3#3#78#656#890#234#678#2#4#678#234#21#345#9#1#9#32#0##
#321012345#1#3#567#34567#76#09#32#4#09#7#3#1#1#32#23#9#54#67#101#345#9012345#901#56#234#67#5#789#1#10#
##3#12#4#67#1234#89#5#7# #56#89#1#5#9876545#109#101#1# #345# #9#12#45#1#3#56#01#5#78#45#7#54#6#890#09#
#545#34#8#8901#567#54567#54#87#901#3#9#76#6#0#87#90109#12#65#9890123#123#7678#23456#656789#3#5678#6#8#
#6#67#567#90#234#89#3#5# #34#678#2#210#8# #8987678#2#890# #45#78#23#10#2#87#90#4#6#0#6#8#01234#8#45#7#
#78#89#7#7#12#4#8#0#2345#12#45#90#2#2#090#67#9#56#43#7#90#23456#43#7#9012#890#4567890#6#21#3#5#9#3#56#
#8#8#01#567#345678901#5#90#23# #1012# #0#65#5#54#65#5678901#5#78#45678#2#4#0#23#7#9#1#54#2#4#67#1234##
##876#234#89#5#7#9#1#7678901#5#7#9#12#4#6#434543#7#34#67#1#5#7#90#67#901234#21#98#89#5#3#3456#8901#56#
#09#543#56#01#3#5#323#78#0#23456789012345#32#6#23#123#5#32345678#2#890#2#4#8#01#7678#4323#3#7890#23#7#
#1#76#45#789012345#345#9#1#3#5#78#01#34#67#10#01#901#345#1#3#7#9#1090#43#56789#3#56#4#21#123#9#12#4#8#
#23#78#678#01#3#5# #5#9#323#7678#212#45#7#1#989#78#212#6#0#2#8#01#1#123#76#8#01234#43210901#98#234#09#
##4#8#87#90#23#767#76789#3# #7#901#34#67#10#87#56#8#0#8789012# #23#32#456#0901#34#2#4#2#8#23#78#4#090#
#65#90#8#0#434#8#89#78#0123#7#90#23#56#89#98#6545#789#9#90#234#6#45#345#78#0#234#212#4#678#456#0# #89#
#7# #109#12#4#8#09#98#21#345678#4345#78#01#7#7#3456#0#0#0#234#654#6#4#67#901#34#8#0#43456#4#6#890#878#
#89#32#01#34567#101#9#323#5#7#90#45#98#21#567#12#6# #4#0901#56#434#6545#78#01#5#7#90#2#6#434#67#12#67#
#9# #34#234#67#321#10123#767#10# #6#090#234#890# #8#434#89#76#0#2#87#3#767890#4#678901#78#2#45#5#3456#
#01#54#43#567#54#232#2#456#89#12#878#0#43#5#9#12#678#2#6789#789012#8#23#5#9#12345#90#23#901234#43#56##
##0#6#65#1#7# #5#3#34#8#678#01234#8#0#654#67#32345#901#56#01#9#9#3#9#1234#8901#56#01#3#7#1#3#56#2#4# #
#0987876#0989#7#5454567#7#90#23#567890#6#87#54#4#678#234#2123#78#45#901#567#1#7678#234567#54#67#1234##
#1#9#9#78#09#76#65#5#7#9890#434567#9#1#7#9#5#5#567#90#4#8#0#456#2#678#234#89#3#7#90#4#6#89#56#890#4#8#
##10#01#90#0#656#67#989#9#1#54#6#8#0#2#89#34#676#890#45#7890#4#21#7#901#34#012#67#12#878#0#456#01#567#
#32#21#5#12#6#4#2#8#09#101#7656#09#1234#012345#789#123456#01234#098909#123#1#345#3#34#8#0#234#21#34#8#
##3#32345#345#32109#1#5#12#8#6#0#012#456#2#4#6#8#0#23#56#212#4#8#0#0#890#45#9#56#21#5678901#56#012#09#
#5454#4#6#45#54#21#5#543234#878901#345#78# #8789#12#456#43#3#5678#4#67#12#6789#78#0#6#8#0#234#89#3#10#
#6#6#2#8765#76#43234565#3#56#8#0#23#5#9#90#4#6#0#23#56# #454#6#8#2345#90#6#8#01#9#90#2#2123#567#7#90##
#7#7#12#87#98#0#4#4#67# #1#78#21#34#6789#12345#123#7678#2#65#7#9012#678#45#789#10#8#012#2#45#7#7678#2#
##9890#2#8#0#890#656#89#109#9#3234#87#9#32#4#67#3# #7#9012#6#8#0#2#87#9#3#56#01#1#7#9#343#5#989#5#901#
#3#9#1#1090#67#987#7#9#3#98#0123#5678#0#4#656789#9#7#3#1#34567#1#3#78901234#21#32#678#23# #789#34#01##
#210#2#2#0#45#1#98#89012#876#2#4#6#8#212#2#6#89#9876#2#2345#7#1#54567#1#3#56#23#345#9#1#3#567#12#0#23#
#3#1#34#2123#9010#090#2#09#5434#878#8#2#212#4#0#09#5#10#4#678901#56#89#54#6#434#4#678901234#890#8901##
#45#1#5432#4#8#2#21#12#01#76#4#89#9#78#8#01#34#6#0#45#9#56#89#1#1#78901#56#8#456#878#0#2#4#2#01#7#901#
#5#909#5#3#5678# #232#09#98#6567#3#56#67890123456#23#9876#09#9#1098#01#76#87656#098#01#3#5#121#56789##
#678#876#456#8#2#43#34#8#0#87#7#1234#45#9#1#3#5#7#123#98#21#789#1#901#1#7#9#7#78#0#09#5456#0#234#89#9#
#7#9098#0#6#0901234#4567#10989#10#4#23#78#01#76#8901#3#9012#6#0123#1#101#789#98#4#6#89#5#789012#090#8#
#89#1#909878#01#3#565#789#10#01#98#01#76#8901#78#0#232101#3456#2#4#23#9#76#89#9#345678#65#9#12#090#87#
#9#3210#0#8#212#456#6#89#32#0#23#789#3#567#123#78#43#3#1#5#5#78#2343#789#567#1012#67#90#4#0#234#8# #6#
#0#4#21#1#90#2345#78#09#54#898#456#01234#8#2#456#65#5#3234567#9012#4567#34#89#1#3#789#1234#23#5678#65#
#1#5#323#10#8#4#67#90101#567#765#78#23#56#43456# #6#43#3#56#8901#34#6#8#2#09#1#545#9#32#45#1#3#7#90#4#
##9#54#45#1#765#7#7#1#1#76#8987# #901#9#78#4#678#878#21#7678#0#23#56#09012#0901#5#101#345#9012#89#123#
#78#656#6#23#7#98#6#23#78#2#0#89#10#2#89#90#8#8#2#6#21098#8#21#34#6789#1#34#89#7# #1#54#678#2#6#01#3##
#6#0#67#78#456#0#6543456#012#09#32#43#78#0#87#901#56#2#0#090#23#567#90123#567#767#90#6#878#4345#1#545#
#5#98789#765#78#87#5#5#789#3#1#5#3#54567890#678#23456#6#4#0#43#76#8901#3#76#89#5#78#8789#90#4#67#5#56#
#43#98#01#7678#2#876#6#8#01#323454#6#6#8#0#45#90#4#6#6543212#45#78#0#2345#78#0#456# #8#0#0#65678#4#67#
##210#6#098#89012#6#8#0#21#54#4#6#2#878#2123#90#656# #4#4#234#6#8#4#43#567#90123#78#6#8#2#87#7#9#345##
#43#1#56#0#090#234567890#234# #2#2109#9#32#4#8#87#78#2345#34#878#234#4#67#10#2#45#9#567#109#5#1012#67#
##4#234#21#1#1234#6#89#1#34#8#012#2#01#5#345678#89#901#567#5#9#901#56567#9#123#5#1#34#89#1#5432#2#8#8#
#65#3#543#32#2#4#878#01#5#56789#3434#234545#78#8#0101#76#876#0#0#23#7#7#987#3456#0#2#67#9#1#3#343#7#9#
##654#6#454#43456#890#23456#8#012#4#8#4#6#6#8#678#2#2#6789#7890#4#4#89#3#7654#678901#5#989012#4#456#0#
##7#567#5#56#4#6789#123#5#78#21#345678#8#8#0#65#7#3#345#9#7#9#1234#8#0#2#8#6#0#8#0#2345#7#1#34#65#789#
#3#767#767676567#9#32#4#67890#23#5#7#9#767890#4565454#67#767# #3#5678901#98789090#6#45#76#2#4567#98#0#
#2#8#89#7#7#7#7#10#4#6567#9#12#4567#1#3#5#7#1234#6#65#789#567#5#7#7#9#1#7#9#9#10#456#6#65#34#6#89#901#
#109#90#8#8989890#6#0#6#89# #3456#890123456#2#4#878#67#90#45#54567#10#2#67#101#123#7878#4#4#878#0#01##
##1#5#12#4#0#0#0#45#987#9#5#7#5#789#1#34#6#434#098# #890123# #3#5#7#1#345#90#232#4#8#8#23#567#90#21#5#
#32345#343212#2123#10#8#0#456#67#9#1#54#878#23#10#4# #0#2#45#123456#234#678#43#34#09090123#7#10#4#234#
#4#4#67#5#3#34#2#4#2#090123#787# #10#6#09#901#901234#0#434#6#0#2#6#434#2#8#23#54#89#1#1#34#89#1234#4##
##656#89#545#5434#6#4#0#2#45#9#   #9#789#101#78#2#4#098#45#78901#78#4#010901#7#567#32#234#4#01#3#5656#
#4#6#09#765#9#54#6543212#6#678# # #89#90#2#2#6#0#65#1#765#98#0#23#765#9#1#1#56#6#89#343#5#3#1#1#34#67#
#32#21#98#6#8765#7#54#234567#90# #87#1012#4345#90#67#98#67#9#123456#67890#2#4#878#01#54#6#2#2#012#456#
##10#210#4#09#76#65656#45#7#10#2#4#67#1#34#4#67890#89#9#78#0123#5#7#78#0#43#3#9#90123#56#012#09#123#7#
# #90#2#4321#98#2#4#6#0#67#7#1#12345# #9#5656#89#12#01098901#3#767#1#9#1#5#12#0#0#2#45#789#34#890#4#8#
##78#43#5#3#9#90123#78987#767#90#4#67#987#7#789#32# #2#0#01#5#98#8901#323#90#2# #43#5678#01#5#78#65#9#
#56# #45654#89#1#3#989#9#5#5#78#0#6#89#76#898#0#4#0#434#21#545#909#12343#78#212#65#1#78#21234567#7#10#
#4# #65#7#567#32#4#0#0#0#4#456789#5#987654#0#2123#98#4#43# #3#10#0#2#45#76#8#012#6#01#90#2#45#789# #1#
#32#0#6789#7#54345#1#1#1#323#7#9#543#9#7#321#3#3#7#7#56#45#323#1#12#0#67#567890#8789#10#434#6#89# #32#
##109878#01#9#5#5#32#23#7#1#3#78#6#2#01#54#2345456#65#7#567#1#32#2#0987#54#67#109#901212#4# #09#7#7#3#
#7#1#9#90109876767#12#456#012#6#8#012#2#6# #4#6#678#45676#89012#6#4#0#89#345#9#10101#3#34#4#21#567654#
#65#101#1#1#9#7#7890#65#789#34567890#23#78#2#87#7#9#34#8#09#1#345#3212#012#6789#1#123#9#5#323#34#67#5#
##432#23#3210#898#0# #6#8#0#4#67#90#01#3#901#9#989012#8#6#0#23#5#54#2#21#3#78#0#23#3#98767#1#32#65#76#
#65#34#4#43#109#9#12#8789#12#2#8#01#9#123#1#10#09#12#87#5#12#45#56#8#0#23456#8#43#54#0#8#8901#12#45#7#
##67#56#65#32#01#9#34#8#01#3#10901#78#0#23#32#21#1#34#654323#5#54#67890#4#6#8765#76#21#9#9#12#0#23#7##
#4#8#6787#54#21#98#4#0# #2345#9#1#5678901#54#43#10#4#65#54#4567#3456#0#65#78#8#6#878#2#0#012#8901#567#
#3#987#989#56#23#765#90#4#4#6789#345#9#12#65#5#9#9#56#434#6#67#12#6#010#67#90#878#8#8#212#2#67#1234#8#
#2109#10#01#7#3#98#678#234#87#9012#6#01#3456#678#87678#2#456#8901#789#987#10#4#8#09#76#234345# #3#567#
#3#1#7#1#1#76545#9#7#901#56#8#0#2#87#1#5#5#787#909#7#90123#7890#23#9#10#8#21234#8#01#5434#4#67#54567##
##32#6#2#23#76#6789#10#2#67#9012#6#89#345#98#8#0#0989#12#45#9#12345#32#6#6#23#56789#76#45#56789#5#789#
#54#654343#98#2#89#32#6#878#0#23456#012#67#9#90#4#09#32#6#6#0#2#4#6#43456543#7#7#9#1#78#676#8#0#678#0#
#6#0#65#3210#210901#345#9#901#3#56# #2#678#01#1#32101#3456#212# #0#65#5#76#4567#10#0#890#87890#87#9#1#
#78987#54#2#43#10#234#67#10#23#7678#4345#9#1#32343#123#5#78#234#0987#7#98#0#67#32#090#0#098#012#89#32#
#8#0#876#4345#1#1#3#56#89#12#4#8#8#4#4#67#1# #3#54#2#4#67#901#56#0#8#6#090987#1#34#89#121#901#34#01#3#
##4#2#8#65#56#0#2345#78#01#3456#2#23#5#78901#1#765434#8789#1#56#212#656#0#09#109#5678901#10#234#2#234#
#4321090#6#67890#45#9890#23#56#2121#3#98#01#1098#65#567#9#3234#432#2#4#212#0#2#8767#9#1#32#434#012#4##
#5#32#0#4#2#8#0#6567#90#43#7678#0#012#0#212#2#09#7#76#89#54#456#4#21#343#3#1#34#87#101#54#65#5#90#8#6#
##9#3#123#109#987#7#101234#8#8#09#9#3212#2#6#2109898789#34#656#0#2#012#4#45#9#5#9#321#76#876#678#8765#
#98#45#34#2#0109#98#21#3#567890#8789#3#343#543#1#90#8#012345#789#109#32#4#6#89#101#3#7#7#9#7#7#90#8#4#
##765#1#543#1#1#5#9#32#4#6#8#012#67#54545#76#45#10#6#21#34#67#901#989#1#34567#12#2#456#890#89#5#12#23#
#98#6#01#5# #3234#01234#878#4#2345#7#5#5#987654321#54323#56#8#0#23#78#012#6#8901#34#6#090#09#34323#12#
##98789#767#7#3#321#3#56#8#2343#5#56767#10#8#6#4#23#5#345#78901#3456789#34#6#0#234567#1#12#0123#3#101#
# #9#9#1#7#56#454#23#7#7#901#5#76#4#8#89#12#0#8#43#76#45#9#9#1#54#6#8#0123456#43#56#89# #34#2#4545#9##
##10#0#098#4#0#6#0#4567890#2#67#7#34#09#3210987654567#5678#0123#56#09#1#3#5#7#5# #78#01# #5434#6#6789#
#32#2121#9#3#987890#6#8#0#43#7898#2#21#5#3#1#98#6#6#8767#901#3#7#7#1#5#7#767#5#7#98#21#1#76#4#8#87#9##
##34#23#1012#0#8#0#87#90#65456#0901#1#345#90#090#8789#7#10#2#45678#2#4#67#7#54#678#2#2#09#7#56789#101#
#545#34#2#2#21#9#12#8901#76#678#01#10#2#678#2#0#09#9#98#21#34#67#901234567#1#345#9012#6#8#89#78#0121##
#6#6545434#6#23#32#09#1#56787#901#7#9012#89012# #0#010#43#54#87890#2#4#6#89012#67#1#34567#9#98#2#2#23#
#78#6#6#4#6543# #34#0#234#8#89#1#56789#34#0#2#   #212#6#4#6#2#89#123456#09#12#6#8#2345#7#5#3#9012#8#4#
##90# #656#6#45#54321234#090901234#8#01#56#434# #43#3456# #210901#3#5#78#0#2345#90#4#67#543210#2#8765#
###################################################################################################76#
