path of length 40 found
#01###################
#123#101#90#01#5#7890#
#2#45#9#98#89#34567#1#
##2#6789#7678#2#4#8#2#
#21#78#01#5#90123#901#
##098#2#234#01#3#78#2#
#21#9012#4#21#5456#23#
#323#1#3456#0#6#6#01##
##345#9#5#789#78789#9#
#54#678#67#9#9#9#9#78#
#6#0#8987#10#8#010#6##
#789#90#8901#7890#456#
##9#3#1#9#1#56#01234##
#1012#2#0#234#8#2#4# #
##1#3434#8#4#87#34#  #
#32#4#4#87656#654#4# #
##3#5656#87#7#7#5#32##
#5#76#67898#89#3#3212#
#43#7#78#090#0123#10##
##2#898#21#1#12#45#9##
#2109#901# #3234#6789#
###################90#
